абавя́зан — обязан
абавя́зкова обязательно
абе́д — обед
абе́дзве — обе
або́ — или
або́два — оба
абу́так — обувь
абяца́ць — обещать
агні́ — огни
аго́нь — огонь
агу́льны — общий
ад — от
адбыва́цца_происходить
адбы́цца _ произойти
аддава́ць — отдавать
адда́ць — отдать
адзе́нне — одежда
адзі́н — один
адзіна́ццаць — одиннадцать
адзіно́кі — одинокий
адзі́ны _единственный
адка́з — ответ
адказа́ць — ответить
адка́зваць _ отвечать
адключы́ць _ отключить
адкрыва́ць _ открывать
адкры́ты _ открытый
адкры́ць — открыть
адку́ль — откуда
адле́гласць — расстояние
адна́ — одна
аднаго́ — одного
адна́к — однако
адно́йчы — однажды
адны́ — одни
адпавяда́ць — соответствовать
адпачыва́ць _отдыхать
адпра́віць _ отправить
адра́зу — сразу
а́драс — адрес
адсю́ль — отсюда
адчува́ць _ чувствовать
адчу́ць _ почувствовать
А́зія — Азия
азнача́ць — означать
ака́звацца оказываться
акія́н — океан
акно́ — окно
акрамя́ — кроме
але́ — но
алё́! — алло!
але́й — масло
альбо́ — либо
ама́ль — почти
Аме́рыка — Америка
амерыка́нскі — американский
англі́йскі английский
апо́вяд — рассказ
апо́шні — последний
апрана́цца _ одеваться
апрана́ць — одевать
апрану́ў — одел
апрану́цца — одеться
апрану́ць — одеть
апыну́цца _ оказаться
ара́нжавы _ оранжевый
а́рмія — армия
асабі́сты — личный
асаблі́вы — особый
аста́тняй _ остальной
асцяро́жна _ осторожно
атрыма́цца _получиться
атрыма́ць _ получить
атры́млівацца — получаться
атры́мліваць _получать
атрымо́ўвацца — удаваться
аўто́бус — автобус
аўто́рак — вторник
бабу́лька — старушка
бабу́ля — бабушка
бага́та — много
бага́ты — богатый
ў бакі́ — в сто́роны
пі́нскія бало́ты — пинские болота
Балты́йскае мо́ра — Балтийское море
ба́цька — отец
бацькі́ родители, отцы
ба́чу — вижу
ба́чыў — видел
ба́чыць — видеть
бая́цца — бояться
бе́гаць — бегать
бе́гаюць — бегают
бе́гчы — бежать
без — без
белару́ская _ бел-ская
белару́скі _ бел-ский
белару́скія _ бел-ские
Белару́сь _ Белоруссия
бе́лы — белый
бе́раг — берег
берага́ — берега́
бераце́ — берёте
бі! — бей!
бі́цца — биться
біць — бить
благі — плохой
блакі́тны — голубой
блі́зкі — близкий
бо _ так как, потому что
не бо́йся! — не бойся!
бок — сторона, бок
бо́лей — больше
бо́льш — больше
брат — брат
браты́ — бра́тья
браў — брал
браць — брать
бру́дны — грязный
Брыта́нія — Британия
Брэст — Брест
будава́ць — строить
бу́дзе — будет
бу́дзем — будем
бу́дзеце — будете
бу́дзеш — будешь
будзь! — будь!
бу́ду — буду
бу́дуць — будут
бу́дучы — будущий
буды́нак — здание
буйны́ — крупный
бу́льба — картофель
бура́к — свёкла
быва́ць — бывать
была́ — была́
былі́ — бы́ли
было́ — бы́ло
былы́ — бывший
быў — был
бы́ццам — будто
быць — быть
бягу́ — бегу
бягу́ць — бегут
бяжы́! — беги!
бяжы́ць — бежит
бяжы́ш — бежишь
бярý__беру
бяру́ць — берут
бяры́! — бери!
бярэ́ — берёт
бярэ́ш — берёшь
бяспла́тна _ бесплатно
вада́ — вода
вадасхо́вішчы — водохрани́лище
вае́нны — военный
ва́жны — важный
вазьмі́! — возьми!
вазьму́ — возьму
вайна́ — война
вако́л — вокруг
вам — вам
ва́мі — вами
вас — вас
васемна́ццаць — 18
няма́ вачэ́й _ нет глаз
ва́ш — ваш
ве́дае — знает
ве́дай! — узнай!
ве́даць — знать
ве́даю — знаю
ве́ды — знания
ве́льмі — очень
ве́расень — сентябрь
ве́рыць — верить
вё́ска — деревня
ве́сці — вести
ве́цер — ветер
ве́чар — вечер
вісе́ць — висеть
во́бласць — область
во́зьме — возьмёт
во́зьмеш — возьмёшь
во́зьмуць — возьмут
адно́ во́ка _ один глаз
во́кны — окна
во́льны _ свободный
во́пратка — одежда
во́раг — враг
во́сем — восемь
восемсо́т _ восемьсот
во́семцзесят — 80
во́сень — осень
во́страў — остров
во́стры — острый
во́сь — вот
во́сьмы — восьмо́й
ву́зкі — узкий
ву́ліца — улица
ву́ліцы — улицы
вучы́ў — учил
вучы́цца — учиться
вучы́ць — учить
вы — вы
вывуча́ць — изучать
вы́гляд — вид
выгляда́ць _ выглядеть
выгляда́ю _ выгляжу
вы́даліць — удалить
выдаткава́ць — потратить
выда́тны _ отличный
вы́ехаць — выехать
вы́йдзе — выйдет
вы́йдзеш — выйдешь
вы́йдуць — выйдут
вы́йсці — выйти
вы́йшаў — вышел
вы́йшла — вышла
вы́йшлі — вышли
выкарысто́ўваць — использовать
вы́ключыць — выключить
выліча́ць _ вычислять
вы́лічыць _ вычислить
вы́мавіць _ произнести
вымаўля́ць — произносить
вы́падак — случай
вы́правіўшы исправив
вы́правіць _исправить
вы́разаць _ вырезать
вы́ратаваць — спасти
выраша́ць — решать
вы́рашыць — решить
вы́хад — выход
выхо́дзіць _ выходит
вышэ́й — выше
вышэ́йшы — выше
вядо́ма — конечно
вядо́мы — известный
вязе́ — везёт
вялі́зны _ огромный
вялі́кі — большой
вярну́цца _ вернуться
вярта́цца — возвращаться
вясё́лы — весёлый
вясна́ — весна
вятры́ — ветра́
гавары́ць — говорить
гаво́рка — речь
гадзі́на — час
пяць гадо́ў _ пять лет
гады́ — года́
гай — роща
галава́ — голова
галасы́ — голоса́
гало́дны — голодный
гало́ўны — главный
гара́ — гора
гарады́ — города.
гара́чы — горячий
гаро́дніна — овощи
гаспада́р — хозяин
гаспады́ня — хозяйка
гато́вы — готовый
Герма́нія — Германия
г.зн.(гэта значыць) то есть
гі́нуць — гибнуть
гісто́рыя — история
глыбо́кі — глубокий
глядзе́ць — смотреть
год — год
у тым го́дзе_ в том году
го́лас — голос
го́лы — голый
го́рад — город
го́ркі — горкий
горш — хуже
госць — гость
грама́дства _общество
граць — играть
грашы́ма — деньгами
гро́шы — деньги
губля́ць — терять
гук — звук
гульня́ — игра
гуля́ць _ играть,гулять
гу́чна — громко
гэ́та — это
гэ́тага — этого
гэ́тай — этой
гэ́тая — эта
гэ́ты — этот
гэ́тым — этом
гэ́тых — этих
гэ́тыя — эти
дабры́дзень! — добрый день!
дава́й! — давай!
дава́ў — давал
дава́ць — давать
даве́дацца — узнать
дадо́му — домой
даду́ць — дадут
дае́ — даёт
дае́ш — даёшь
дажджы́ — дожди
дазваля́ць _ разрешать
дазво́ліць _ позволит
дай! — дай!
дакла́дна — точно
дакрані́ся! _ коснись!
далё́ка — далеко
далё́кі — далёкий
даля́р — доллар
ты́я дамы́ — те дома
дапамага́ць _ помогать
дапамагчы́ — помочь
дапамо́га — помощь
дарава́ць — простить
даро́га — дорога
даро́слы — взрослый
дару́й! — прости!
дарэ́чы — кстати
дасі́ — дашь
дасць — даст
даў — дал
даўжыня́ — длина
даўно́ — давно
дах — крыша
даха́ты — домой
даць — дать
дачка́ — дочь
дачкі́ — до́чери
дачко́й — дочерью
дачцэ — дочке
даю́ць — дают
два — два
два́ццаць — двадцать
дзевя́ты — девятый
дзве́ры — дверь
дзве́сце — двести
дзе — где
дзе́вяць — девять
дзесь — где-то
дзе́сьці — где-то
дзе́сяць — десять
дзед — дед
дзяду́ля — дедушка
дзе́йнічаць действовать
дзелавы́ — деловой
дзе́ля — ради, для
дзе-не́будзь — где-нибудь
дзень — день
дзе́ці — дети
дзе́янне — действие
дзі́ўны — странный
дзіцё́нак — ребёнок
дзіця́ — ребёнок, дитя
дзіця́чы — детский
дзя́дзька — дядя
дзяду́ля — дедушка
дзя́каваць — благодарить
дзя́куй! — спасибо!
дзяржа́ва _ государство
дзяўчы́на — девушка
дзяўчы́нка — девочка
для — для
днём — днём
дні — дни
до́бра! — хорошо́!
до́бры — хоро́ший
до́бры дзень! — здра́вствуйте!
дождж — дождь
дом — дом
до́ўга — долго
до́ўгі — длинный
до́ўжыцца — длится
до́чак — дочерей
до́чкам — дочеря́м
другі́ — друго́й
дрэ́ва — де́рево
дрэ́вы — дере́вья
дрэ́нна — плохо
дрэ́нны — плохой
ду́жа — очень
ду́маць — думать
ду́мка — мысль
ду́рань — дурак
дурні́ца — дура
дурны́ — глупый
ды — и, а
дык — то, так
едзь! — поезжай!
еж! — ешь!
е́жа — еда
е́зджу — езжу
е́здзі! — езди!
е́здзіць — ездить
ёй — ей
ён — он
е́сці — есть (кушать)
е́сць — ест
ёсць — есть (имеется)
еў — ел
еўрапе́ец — европеец
жада́нне — желание
жада́ць — желать
жале́зны — железный
жанчы́на — женщина
жні́вень — август
жо́нка — жена
жо́нкі — жёны
жо́ўты — жёлтый
жывы́ — живой
жы́та — рожь
жыццё́ — жизнь
жыць — жить
за — за
забараня́ць _ запрещать
забаро́нена _ запрещено
забіва́ць — убивать
забіць — убить
забу́дзь! — забудь!
забыва́ць _ забывать
забы́ць — забыть
зага́д — приказ
за́гадзя — заранее
загі́нуць _ погибнуть
займа́цца _ заниматься
займі́ся! — займись!
залаты́ — золотой
зале́жаць — зависят
замежны _иностранный
заме́ст — вместо
зана́дта — слишком
заня́ты — занятый
зарабі́ць _ заработать
заставацца _ оставаться
заста́цца — остаться
зато́е — зато
заты́м — затем
заўважа́ць _ замечать
заўва́жыць _ заметить
заўсё́ды — всегда
за́ўтра — завтра
захава́ць _ сохранить
за́хад — запад
зберагчы́ — сберечь
збіра́цца _ собираться
збро́я — оружие
зва́ць — звать
зве́рху сверху снаружи
зво́нку — снаружи
звыча́йны _ обычный
згаджа́цца — соглашаться
здара́цца происходить
здаро́вы — здоровый
зда́рыцца _произойти
зда́цца — показаться
здзіві́цца _ удивиться
здзіўленне _удивление
здыма́ць — снимать
з’ем — съем
з’е́хаць — уехать
з-за — из-за
зза́ду — сзади
зіма́ — зима
зімо́й — зимой
зле́ва — слева
злё́гку — слегка
злы — злой
змагла́ — смогла
змаглі́ — смогли
змагу́ — смогу
змагчы́ — смочь
зме́ншыцца — уменьшится
змог — смог
змо́гуць — смогут
змо́жа — сможет
змо́жам — сможем
змо́жаце — сможете
змо́жаш — сможешь
змясці́цца уместиться
знаё́міцца — знакомиться
знаё́мы — знакомый
знайду́ — найду
знайсці́ — найти
знайсці́ся — найтись
знайшлі́ — нашли
знайшоў́ — нашёл
знахо́джу — нахожу
знахо́дзіцца — находится
знахо́дзіць _ находить
зна́чыць — значить
значэ́нне — значение
зне́шні — внешний
зніка́ць — исчезать
зні́кнуць _ исчезнуть
зні́шчыць уничтожить
зно́йдзе — найдёт
зно́йдзеш — найдёшь
зно́йдуць — найдут
зноў — опять
зняць — снять
зо́лата — золото
зо́рка — звезда
зо́ркі — звёзды
з-пад — из-под
зрабі́! — сделай!
зрабі́лі — сделали
зрабі́ў — сделал
зрабі́ць — сделать
зраблю́ — сделаю
зразуме́й! — пойми!
зразуме́ла — понятно
зразуме́ць — понять
зробі́ць — сделает
зро́блены — сделан
зрэ́шты — впрочем
зусі́м — совсем
зьяду́ць — съедят
з’я́віцца — появится
з’яжджа́ць — уезжать
зялё́ны — зелёный
зямля́ — земля
з’ясі́ — съешь
з’яўля́цца _ появляться
ідзе́ — идёт
ідзё́м — идём
ідзе́ш — идёшь
ідзі́! — иди!
іду́ць — идут
ілга́ць — врать
ім — им
імё́ны — имена́
і́мі — ними
імя́ — и́мя
іна́кш — иначе
інжыне́р — инженер
інтэрнэ́т — интернет
і́ншае — друго́е
і́ншы — другой
і́ншых — других
і́ншыя — другие
існава́ць — существовать
іспа́нскі — испанский
ісці́ — идти
іх — их
ішла́ — шла
ішлі́ — шли
ішо́ў — шёл
каб — чтобы
кава́лак — кусок
каго́ — кого
каза́ў — говорил
каза́ць — говорить
калі́ — если
калі́ ла́ска! — пожалуйста!
калі́-нікалі́ — иногда
калі́сьці — когда-то
каля́ — о́коло
каляро́вы — цветной
камандзі́р — командир
ка́мень — камень
каму́ — кому
каму́сьці — кому-то
камяні́ — ка́мни
кане́ц — конец
карабе́ль — корабль
караблі́ — корабли
кароткі — коро́ткий
кары́сны _ полезный
кары́сць — польза
кары́чневы — коричневый
кастры́чнік — октябрь
каха́нне — любовь
каха́ны — любимый
каха́ць — любить
каштава́ць — стоить
кватэ́ра — квартира
кепскі — плохой
кіда́ць — бросать
кі́нуць — бросить
кінь! — брось!
кіта́йскі — китайский
кладзе́ — кладёт
кладзі́ся! — ложись!
кла́сці — класть
кла́сціся — ложиться
клі́каць — звать
клі́ча — зовёт
клі́чаш — зовёшь
клі́чуць — зовут
кні́га — книга
ко́жны — каждый
ко́ла — колесо, круг
ко́лер — цвет
ко́леры — цвета́
ко́лькасць — количество
ко́лькі — сколько
ко́ска — запятая
краі́на — страна
краі́ны — стра́ны
край — край
крану́ць — тронуть
красаві́к — апрель
кро́пка — точка
кры́кнуць — крикнуть
крыча́ць — кричать
крэ́слы — стулья
куды́ — куда
куды́сьці — куда-то
купі́ць — купить
купля́ць — покупать
кут — угол
лама́ць — ломать
ла́яць — ругать
ле́вы — левый
лё́гкі — лёгкий
ле́гчы — лечь
ледзь — чуть
лепш — лучше
ле́пшы — лучший
лес — лес
ле́свіца — лестница
ле́та — лето
лік — число́
лі́кі — чи́сла
лі́пень — июль
ліст — письмо
лістапа́д — ноябрь
лі́тара — буква
літо́ўскі — литовский
лі́чба — цифра
лі́чбы — цифры
лічы́! — считай!
лічы́ў — считал
лічы́ць — считает
ло́жак — кровать
любі́мы — любимый
любі́ў — любил
любі́ць — любить
любо́ў — любовь
лю́бы — любо́й
лю́дзі — люди
лю́тага, лю́ты февраль
ля — у, при, около
ляглі́ — легли
ля́гуць — лягут
ляж! — ляг!
ля́жаце — ляжете
ляжа́ць — лежат
лясы́ — леса́
лята́ць — летать
ляце́ць — лететь
ляці́! — лети!
магла́ — могла
маглі́ — могли
магу́ — могу
магчы́ — мочь
магчы́ма — возможно
магчы́мы _ возможный
ма́е — имеет
ма́ем — имеем
ма́еце — имеете
ма́еш — имеешь
май! — имей!
майго́ — моего
ма́ла — мало
малады́ — молодой
мале́нькі _ мале́нький
мало́дшы — младший
малы́ — ма́лый
ма́ма — мама
марнава́ць — тратить
маско́ўскі _московский
маўча́ць — молчать
ма́ці — мать
ма́ю — имею
ма́юць — имеют
мая́ — моя
менаві́та — именно
менш — меньше
меркава́нне — мнение
меркава́ць рассуждать, — предполагать
мё́ртвы — мёртвый
ме́сца — место
ме́сяц — луна, месяц
пяць ме́траў 5 метров
ме́цца — иметься
мець — иметь
мі́лы — милый
мільё́н — миллион
мі́ма — мимо
міну́лы — прошлый
міну́лыя _ прошедшие
мір__мир (не война)
мо́ва — язык
мог — мог
мо́гуць — могут
мо́жа — может
мо́жам — можем
мо́жаце — можете
мо́жаш — можешь
мо́жна — можно
мой — мой
мо́ра — мо́ре
мо́ры — моря́
мо́цны — сильный
муж — муж
мужчы́на — мужчина
му́сіць — наверное,
мы _ мы. ́_́ должен
мэ́та — цель
мя́ккі — мягкий
мяне́ — меня
мяня́цца — меняться
мярэ́жка — тропка
мя́са — мясо
набліж́ацца — приближаться
наблі́зіцца — приблизиться
нава́т — даже
наве́дваць _ посещать
наве́рсе — наверху
наве́рх — наверх
навіна́ — но́вость
навока́л — вокруг
наво́шта — зачем
наву́ка — наука
навуча́ць — обучать
нага́ — нога
над — над
надво́р’е — погода
назаўсё́ды _ навсегда
назва́ць — назвать
называ́цца — называться
называ́ць _ называть
найбо́льш _ наиболее
найме́нш — наименее
накшта́лт — вроде
нале́жаць — принадлежать
нале́жыць — принадлежит
нам — нам
на́мі — нами
нао́гул — вообще
напе́рад — вперёд
напе́радзе — впереди
напіса́ць — написать
напры́клад _ например
напэ́ўна — наверное
нарадзі́ўся _ родился
наро́д — народ
нарэ́шце — наконец
нас — нас
насі́ць — носить
наста́ўнік — учитель
настро́й _ настроение
насту́пны _ следующий
на́фта — нефть
наці́снуць — нажать
Нацыяна́льны сход
начны́ — ночной
наш — наш
не — не
неабхо́дны — необходимый
не́ба — небо
неадкла́дна — немедленно
невядо́мы — неизвестный
невялі́кі _небольшой
не́дзе — где-то
незале́жны — независимый
незвыча́йны — необычный
нездарма́ — зря
не́йкі — какой
не́йкага — какого-то не́кага — кого-то
не́калькі — несколько
не́каму — кому-то
некато́ры _ некоторый
не́кім — кем-то
не́куды — куда-то
не́льга — нельзя
немагчы́мы — невозможный
ненаві́дзець — ненавидеть
непадо́бны _непохожий
не́сці — нести
неўза́баве — вскоре
не́хта — кто-то
не́чага — чего-то
нечака́на _ неожиданно
не́чаму — чему-то
не́чым — чем-то
не́шта — что-то
не́як — как-то
ні — ни
ні́бы — словно
ніж — чем
ні́жні — нижний
ніжэ́й — ни́же
ні́зкі — низкий
ніко́га — никого
ніко́лі — никогда
ніко́му — никому
ніку́ды — никуда
ніхто́ — никто
нічаму́ — ничему
нічо́га — ничего
нічы́м — ничем
нішто́ — ничто
нія́к — никак
нія́кі — никакой
но́вы — новый
ноч — ночь
нуль — ноль
ну́мар — номер
нумары́ — номера
ня — не
нябё́сы — небеса́
нягу́чны — негромкий
няда́ўна — недавно
нядзе́ля _ воскресенье
няма́ — нет
няме́цкі — немецкий
няўжо́ — неужели
па — по
да пабачэ́ння! — до свидания!
паве́даміць _ сообщить
паведамля́ць сообщать
паве́рх — этаж
паве́рыць _ поверить
паве́тра — воздух
паві́нен — должен
паво́льны _ медленный
паво́дзіць сябе́ — вести себя
павялі́чыцца — увеличится
пагадзі́цца — согласиться
пад — под
падаба́ецца _ нравится
падабацца _ нравиться
пада́ць па́дать, пода́ть
падзе́я — событие
падло́га _ пол (в доме)
падману́ць _ обмануть
падня́ць — поднять
па-друго́е _ во-вторых
пады́дзе — подойдёт
падыма́цца — подниматься
падысці́ — подойти
падыходзіць _подходит
падышо́ў — подошёл
пае́ду — поеду
пае́хаць — поехать
пажылы́ — пожилой
пазнава́ць _ узнавать
пайду́ — пойду
пайсці́ — пойти
пайшлі́ — пошли
пайшо́ў — пошёл
паказа́ць — показать
пака́зваць — скрыть
пакіда́ць — оставлять
пакі́нуты оставленный
пакі́нуць — оставить
пакла́сці — положить
пако́й — комната
пако́лькі — поскольку
паку́ль — пока
паку́та — мука
Пале́ссе — Полесье
палі́ — поля
паліто́ — пальто́
паліты́чны — политический
пало́ва — половина
паля́к — поляк
паля́чка — полячка
памё́р — умер
паме́рла — умерла
паме́рці — умереть
памі́ж — между
паміра́ць — умирать
па-мо́йму — по-моему
памы́лка — ошибка
памыля́цца _ошибаться
па́мятаць — помнить
па́мяць — память
панядзе́лак — понедельник
папе́ра — бумага
па-пе́ршае _ во-первых
папрасі́ць _попросить
пара́дак — порядок
пасла́ць — послать
пасля́ — после
паспе́ць — успеть
паспрабава́ць — попро́бовать
паста́віць _ поставить
пасыла́ць _ посылать
патрабава́ць — требовать
патрэ́бны — нужен
патэлефа́наваць — позвонить (по тлф.)
паўднё́вы — южный
паў(до́ма) _ пол(дома)
паўно́чны _ северный
паўтара́ — полтора
паўтара́ць _ повторять
паўтары́ць _ повторить
пах — запах
пача́так — начало
пача́цца — начаться
пача́ць — начать
пачне́ш — начнёшь
пачну́ць — начнут
пачуццё́ — чувство
пачу́ць — услышать
пачына́ць _ начинать
пераве́сці _ перевести
перамагчы́ _ победить
пераста́ць _ перестать
перш — прежде
пе́ршы — первый
піса́ць — писать
піць — пить
пі́ша — пишет
пла́каць — плакать
плаці́ць — платить
пло́шча — площадь
плыве́ — плывёт
плыць — плыть
плячо́ — плечо
по́бач — рядом
по́йдзе — пойдёт
по́йдзеш — пойдёшь
по́йдуць — пойдут
по́руч — возле
по́тым — пото́м
по́ўдзень — юг
на по́ўдні — на юг
по́ўнач — север
по́ўны — полный
по́шта — почта
на по́шце — на почте
пра — о, про
пра каго́? — о ком?
праве́рыць _ проверить
прадо́ўжыць — продолжить
прада́ць — продать
праз — через, из-за
прайсці́ — пройти
пра́ма — прямо
прамы́ — прямой
прапанава́ць — предложить
прапано́ўваць — предлагать
прасі́ць — просить
прасто́ра — пространство
праўдзі́вы _истинный
прахо́дзіць _ проходит
пра́ца — работа
працава́ць _ работать
працо́ўны — рабочий
прачыта́й! _ прочитай!
прачыта́ць _ прочитать
про́звішча _ фамилия
про́йдзе — пройдёт
про́сты — просто́й
пры — при
прывіта́нне — приве́т
прыго́жы _ красивый
прые́ду — приеду
прые́хаць — приехать
пры́йдзе — придёт
пры́йдзеш _ придёшь
пры́йдуць — придут
прыйсці́ — прийти
пры́йшла — пришла
прыйшо́ў — пришёл
пры́клад — пример
прыму́сіць _ заставить
прыне́сці — принести
прыно́сіць _ приносить
прыня́ць — принять
прыхо́дзіць _ приходит
прыхо́дзь! _ приходи!
прычы́м — причём
прыязджа́ць — приезжать
пту́шка — птица
пыта́нне — вопрос
пыта́цца _ спрашивать
п’ю — пью
рабі́цца — делаться
рабі́ць — делать
раблю́ — делаю
рабо́чы — рабочий
рабя́ты — ребята
ра́дасць — радость
ра́дыё — радио
раё́н — район
адзі́н раз — один раз
ра́зам — вместе
размаўля́ць — разговаривать
размо́ва — разговор
пяць разо́ў _ пять раз
разуме́ць — понимать
разуме́ючы _ понимая
разу́мны — умный
тры разы — три раза
рака́ — река
няма́ ракі́ _ нет реки́.
ране́йшы — прежний
ра́ніца — утро
ра́ніцай — утром
ра́ніцы — утра́
ра́птам — вдруг
расказа́ць _ рассказать
раска́зваць — рассказывать
распаве́сці _рассказать
распрану́цца раздеться
растлума́чыць — объяснить
расце́ — растёт
расці́ — расти
ратава́ць — спасать
раша́ць — решать
ро́бім — делаем
ро́біце — делаете
ро́біць — делает
ро́біш — делаешь
ро́бяць — делают
ро́днай — родной
ро́зны — разный
ро́зум — ум
ро́ўны — равный
ружо́вы — ро́зовый
рука́ — рука
ру́скі — русский
рух — движение
ру́хацца — двигаться
даў руцэ́ — дал руке
гэтыя рэ́кі — эти ре́ки
рыс — рис
ры́са — черта
сабе́ — себе
сабо́й — собой
сабо́ю — собою
сабра́цца _ собраться
саджу́ся — сажусь
садзі́цца — садиться
сайт — сайт
сакаві́к — март
салё́ны — солёный
сало́дкі — сладкий
са́мі — сами
само́га — самого́
са́мы — самый
сапра́ўдны истинный
свае́ — свои
сваё́й — своей
сваі́мі — своими
сваі́х — своих
свайго́ — своего
сваю́ — свою
свая́ — своя
сваякі́ родственники
свет _ мир (вселенная)
све́тлы — светлый
све́ты — миры́
свой — свой
свя́та — праздник
святло́ — свет
свя́ты — праздники
сё́мы — седьмой
сем — семь
семсо́т — семьсот
сё́ння — сегодня
се́сці — сесть
сі́ні — синий
сказа́ў — сказал
сказа́ць — сказать
скака́ць — прыгать
скапіява́ць — скопировать
склада́ны _ сложный
ско́нчыцца _ закончится
скрозь сквозь, везде
слаць — слать
сло́ва — сло́во
сло́вы — слова́
няма́ слоў — нет слов
сло́ўнік — словарь
служы́ць — служить
слу́хаць — слушать
смерць — смерть
смець — сметь
смяя́цца — смеяться
сне́жань — декабрь
со́нца — солнце
со́рак — сорок
со́ты — сотый
сто — сто
спада́р — господин
спадары́ — господа
спадзява́цца — надеяться
спадні́ца — юбка
спажыва́ць — потреблять
спаць — спать
спача́тку — сначала
спераду́ — впереди́ ́
спецыя́льны — специальный
спрабава́ць _ пытаться
спра́ва — дело
спра́вы — дела
спыні́цца — остановиться
спыні́ць _ остановить
спыня́ць останавливать
спытаць — спросить
спява́й! — пой!
спява́ць — петь
ста́віцца — отно́сится
ста́віць — ставить
стаго́ддзе — век
стаго́ддзя — века
ста́ла — стало
сталы́ — столы
стамі́цца — устать
станаві́цца — становиться
стано́віцца _становится
стара́цца — стараться
старо́нка — страница
старо́нні _ посторонний
стары́ — ста́рый
старэ́йшы — старший
стаць — стать
стая́ць — стоять
ствара́ць _ создавать
ствары́ць — создать
стой! — стой!
сто́млены _ уставшый
сто́лькі — столько
страля́ць — стрелять
стра́ціць — потерять
сту́дзень — январь
субо́та — суббота
суке́нка — платье
су́праць — против
сур’ё́зны _ серьёзный
сусе́д — сосед
сустрака́ць _встречать
сустрэ́ць — встретить
сустрэ́ча — встреча
сусьве́т — вселенная
су́ткі — сутки
сухі́ — сухой
суча́сны _современный
схапі́ць — схватить
сце́жка — тропа
сцяна́ — стена
сыдзе́ — уйдёт
сыдзе́ш — уйдёшь
сыдзі́! — уйди!
сыдучы́ — уйдя
сын — сын
сыны́ — сыновья
сысці́ — уйти
сыхо́дзіць — уходит
сышлі́ — ушли
сышоў́ — ушёл
сэнс — смысл
сэ́рца — сердце
сюды́ — сюда
ся́бар — друг
сябе́ — себя
сябро́ўка — подруга
сябры́ — друзья
сяда́й! — садись!
сяджу́ — сижу
сядзе́ць — сидеть
сям’і́ — се́мьи
сям’я́ — семья́
сяро́д — среди
сярэ́дзіна _ середи́на
сярэ́дні — средний
табе́ — тебе
табо́й — тобой
таго́ — того
тады́ — тогда
такі́ — такой
такса́ма — также
таму́ _ потому , затем,
тому назад
таму што — так как
та́нны — дешёвый
та́та — папа
та́я — та
тва́р — лицо
твары́ць — творить
твой — твой
тлума́чыць _ объяснять
то — то
той — тот
то́лькі — только
то́нкі — тонкий
то́ўсты — толстый
тра́вень — май
тро́хі — немного
тры — три
трыма́й! — держи!
трыма́цца _ держаться
трыма́ць — держать   
тры́ста — триста
тры́ццаць _ тридцать
трэ́ба — нужно
трэ́ці — третий
трэць — треть
туды́ — туда
турбава́цца — беспокоиться
турбава́ць _ беспокоить
тут — здесь
ты — ты
ты́дзень — неделя
ты́дні — недели
тых — тех
ты́чыцца — касаться
угары́ — вверху
Украі́на — Украина
украі́нец — украинец
украі́нскі украинский
ула́сны _ собственный
улюбля́цца — влюбляться
уні́зе — внизу
умілава́ны — возлюбленный
успо́мніць _ вспомнить
уста́нь! — встань!
ўба́чу — увижу
ўба́чыць — увидеть
ўва́га — внимание
ўвайду́ — войду
ўвайсці́ — войти
ўвайшоў́ — вошёл
ўвахо́дзіць — входит
ўвесь — весь
ўверх — вверх
ўво́йдзеш — войдёшь
уво́йдзе — войдёт
ўвойдуць — войдут
ўдара́ць — ударять
ўда́рыць — ударить
ўдзе́льнічаць — участвовать
ўжо́ — уже
ўжыва́ць _ применять
ўздо́ўж — вдоль
ўзро́ст — возраст
ўзяў — взял
ўзя́ць — взять
ўключы́ць _ включить
ўла́да — власть
ўме́ць — уметь
ўні́з — вниз
ўну́к — внук
ўну́траны _ внутренний
ўнутры́ — внутри
ўперад — вперёд
ўпершыню́ _ впервые
ўпэ́ўнены уверенный
ўра́д _ правительство
ўсё́ — всё
ўсі́м — всем
ўсі́х — всех
ўслы́х — вслух
ўсме́шка — улыбка
ўсміхну́цца — улыбнуться
ўсміха́цца _ улыбаться
ўспаміна́ць — вспоминать
ўстава́ць — вставать
ўста́віць — вставить
ўста́ць — встать
ўсхо́д — восток
ўсю́ды — везде
ўсе́ — все
ўсё́ — всё
ўся́ — вся
ўчо́ра — вчера́
ўяві́ць — вообразить
хава́ць — скрывать
хадзе́м! — пойдёмте!
хадзі́ць — ходить
хай! — пусть!
хало́дны _ холодный
хапа́ць — хватать
хапі́ць — хватить
ха́та — дом
ха́ты — дома
хаце́ць — хотеть
хачу́ — хочу
хваро́ба — болезнь
хварэ́ць — болеть
хвілі́на — минута
хво́ры — больной
хі́ба — разве
хло́пец — парень
хло́пцы — парни
хло́пчык — мальчик
не хлусі́! — не ври!
хлу́сіць — врать
хоць — хотя
хо́ча — хочет
хо́чам — хотим
хо́чаце — хотите
хо́чаш — хочешь
хо́чуць — хотят
хто — кто
хто-не́будзь — кто-то
хто́сьці — кто-то
худы́ — худой
ху́тка — быстро
ху́ткасць — скорость
ху́ткі — быстрый
ца́лкам — полностью
цана́ — цена
царква́ — це́рковь
цвё́рды — твёрдый
це́ла — тело
це́лы — тела
цё́мны — тёмный
це́мра — тьма
цё́плы — тёплый
цё́тка — тётя
ці — или
ціка́вы — интересный
ці́ха — тихо
ці́хі — тихий
цішыня́ — тишина
цудо́ўны — чудесный
цу́кар — сахар
цэ́лы — целый
цябе́ — тебя
цягні́к — поезд
цягну́ць — тащить
цяжкі́ — тяжёлый
цяпе́р — сейчас
чаго́ — чего
ад чаго́? — от чего?
з-за чаго́? — отчего?
да чаго́? — к чему?
чаго́сьці — чего-то
чака́ць — ждать
чалаве́к — человек
чалаве́чы — человеческий
чаму́ — почему
чаму́сьці — почему-то
час — время
ча́сам — иногда
ча́ста — часто
ча́стка — часть
часы́ — времена
чаты́ры — четыре
чацве́р — четверг
чацвё́ра — четверо
чацвё́рты _ четвёртый
чвэрць — четверть
чо́рны — чёрный
чуць — слышать
чыё́й — чьей
чыі́м — чьим
чыі́х — чьих
чы́й — чей
чыйго́ — чьего
чый-не́будзь — чей-либо
чы́йсьці — чей-то
чы́м — чем
аб чы́м? — о чём?
чы́мсьці — чем-то
чырво́ны — красный
чы́сты — чистый
чыта́ць — читать
чыю́ — чью
чыя́ — чья
чэ́рвень — июнь
шклы — стёкла
шкло́ — стекло
шлях — путь
шляхі́ — пути
шмат — много
шматлі́кіх — многих
шматлі́кія — многие
шо́сты — шестой
шпацырава́ць — гулять
штаны́ — брюки
што — что
што́сьці — что-то
штурха́ць — толкать
шука́е — ищет
шука́й! — ищи!
шука́ць — искать
шука́ю — ищу
шчаслі́вы счастливый
шча́сце — счастье
шыро́кі — широкий
шэ́ры — серый
шэ́сць — шесть
шэсцьсо́т — шестьсот
шэсцьцзеся́т — 60
я — я
яго — его
яду́ць — едят
яе — её
я́йкі — яйца
як — как
я́касць — качество
яка́я — которая
які́ — который
які́я — которые
як-не́будзь _ как-нибудь
яко́га — которого
ямо́ — едим
яму́ — ему
яна́ — она
яно́ — оно
яны́ — они
ясі́! — ешь!
я́сна — ясно
ясце́ — едите
яшчэ́ — ещё
